Feature ID	Taxon	Confidence
MAG1	d__Bacteria;p__Bacillota_E;c__DYFQ01;o__DYFQ01;f__;g__;s__	0.92
MAG2	d__Bacteria;p__Pseudomonadota;c__Alphaproteobacteria;o__Thalassobaculales;f__Thalassobaculaceae;g__;s__	0.95
MAG3	d__Bacteria;p__Bacillota_F;c__Halanaerobiia;o__Halanaerobiales;f__DTU029;g__JAKSCG01;s__	0.97
MAG4	d__Bacteria;p__Pseudomonadota;c__Alphaproteobacteria;o__Sphingomonadales;f__Sphingomonadaceae;g__Qipengyuania;s__Qipengyuania flava	0.99
MAG5	d__Bacteria;p__Bacteroidota;c__Bacteroidia;o__Bacteroidales;f__UBA12077;g__UBA12077;s__	0.9
MAG6	d__Bacteria;p__Pseudomonadota;c__Alphaproteobacteria;o__Rhizobiales;f__Rhizobiaceae;g__Nitratireductor_A;s__	0.9
MAG7	d__Bacteria;p__Pseudomonadota;c__Gammaproteobacteria;o__Nitrosococcales;f__Methylophagaceae;g__Methylophaga;s__Methylophaga sp014762585	0.95
MAG8	d__Bacteria;p__Pseudomonadota;c__Gammaproteobacteria;o__Enterobacterales_A;f__Alteromonadaceae;g__Pseudidiomarina;s__Pseudidiomarina aquimaris	0.93
MAG9	d__Bacteria;p__Pseudomonadota;c__Gammaproteobacteria;o__Halothiobacillales;f__Halothiobacillaceae;g__Guyparkeria;s__Guyparkeria hydrothermalis	0.94
MAG10	d__Bacteria;p__Planctomycetota;c__Phycisphaerae;o__Sedimentisphaerales;f__SG8-4;g__PLanc-01;s__	0.88
MAG11	d__Bacteria;p__Pseudomonadota;c__Gammaproteobacteria;o__Pseudomonadales;f__Oleiphilaceae;g__Marinobacter;s__	0.95
MAG12	d__Bacteria;p__Bacteroidota;c__Bacteroidia;o__Flavobacteriales;f__Flavobacteriaceae;g__Muricauda;s__Muricauda sp010468565	0.94
MAG13	d__Bacteria;p__Pseudomonadota;c__Alphaproteobacteria;o__Rhodospirillales_A;f__Thalassospiraceae;g__Thalassospira;s__Thalassospira povalilytica	0.92
MAG14	d__Bacteria;p__Pseudomonadota;c__Gammaproteobacteria;o__Pseudomonadales;f__Halomonadaceae;g__Halomonas;s__Halomonas gudaonensis	0.98
MAG15	d__Bacteria;p__Pseudomonadota;c__Gammaproteobacteria;o__Enterobacterales_A;f__Alteromonadaceae;g__Pseudidiomarina;s__Pseudidiomarina andamanensis	0.96
MAG16	d__Bacteria;p__Acidobacteriota;c__B3-B38;o__;f__;g__;s__	0.92
MAG17	d__Bacteria;p__Bacteroidota;c__Bacteroidia;o__Cytophagales;f__Cyclobacteriaceae;g__JAAUQL01;s__	0.97
MAG18	d__Bacteria;p__Pseudomonadota;c__Gammaproteobacteria;o__Thiomicrospirales;f__Thiomicrospiraceae;g__Hydrogenovibrio;s__Hydrogenovibrio thermophilus	0.98
MAG19	d__Bacteria;p__Pseudomonadota;c__Gammaproteobacteria;o__Enterobacterales_A;f__Alteromonadaceae;g__Idiomarina;s__Idiomarina zobellii	0.93
MAG20	d__Bacteria;p__Pseudomonadota;c__Gammaproteobacteria;o__Pseudomonadales;f__Alcanivoracaceae;g__Alcanivorax;s__Alcanivorax profundimaris	0.88
MAG21	d__Bacteria;p__Pseudomonadota;c__Gammaproteobacteria;o__Pseudomonadales;f__Oleiphilaceae;g__Marinobacter;s__Marinobacter nauticus	0.96
MAG22	d__Bacteria;p__Pseudomonadota;c__Gammaproteobacteria;o__Nitrosococcales;f__Methylophagaceae;g__Methylophaga;s__Methylophaga sp014762585	0.98
MAG23	d__Bacteria;p__Pseudomonadota;c__Gammaproteobacteria;o__Pseudomonadales;f__Alcanivoracaceae;g__Alcanivorax;s__Alcanivorax profundimaris	0.98
MAG24	d__Bacteria;p__Pseudomonadota;c__Gammaproteobacteria;o__Enterobacterales_A;f__Alteromonadaceae;g__Idiomarina;s__Idiomarina sp002808045	0.95
MAG25	d__Bacteria;p__Pseudomonadota;c__Gammaproteobacteria;o__Pseudomonadales;f__Halomonadaceae;g__Halomonas;s__Halomonas aquamarina	0.92
MAG26	d__Bacteria;p__Pseudomonadota;c__Gammaproteobacteria;o__Enterobacterales_A;f__Alteromonadaceae;g__Idiomarina;s__Idiomarina sp002685255	0.98
MAG27	d__Bacteria;p__Pseudomonadota;c__Gammaproteobacteria;o__Pseudomonadales;f__Oleiphilaceae;g__Marinobacter;s__	0.94
MAG28	d__Bacteria;p__Patescibacteria;c__JACMRA01;o__JACMRA01;f__;g__;s__	0.92
MAG29	d__Bacteria;p__Pseudomonadota;c__Gammaproteobacteria;o__Pseudomonadales;f__Oleiphilaceae;g__Marinobacter;s__Marinobacter nauticus	0.9
MAG30	d__Bacteria;p__Pseudomonadota;c__Gammaproteobacteria;o__Enterobacterales_A;f__Alteromonadaceae;g__Idiomarina;s__Idiomarina zobellii	0.91
MAG31	d__Bacteria;p__Desulfobacterota;c__Desulfobacteria;o__Desulfobacterales;f__Desulfosarcinaceae;g__;s__	0.9
MAG32	d__Bacteria;p__Pseudomonadota;c__Gammaproteobacteria;o__Pseudomonadales;f__Oleiphilaceae;g__Marinobacter;s__Marinobacter nauticus	0.98
MAG33	d__Bacteria;p__Pseudomonadota;c__Gammaproteobacteria;o__Enterobacterales_A;f__Alteromonadaceae;g__Idiomarina;s__Idiomarina aquatica	0.91
MAG34	d__Bacteria;p__Pseudomonadota;c__Gammaproteobacteria;o__Pseudomonadales;f__Oleiphilaceae;g__Marinobacter;s__Marinobacter salsuginis	0.92
MAG35	d__Bacteria;p__Bacillota_E;c__JAIMBG01;o__JAIMBG01;f__;g__;s__	0.91
MAG36	d__Bacteria;p__Bacillota_E;c__DYFQ01;o__DYFQ01;f__;g__;s__	0.89
